[Size]
Width = 75
Height = 75

[Textures]
Tex1 = gras.jpg
Tex2 = way.jpg

[Fields]
Gras = G
Way  = +

[Field_Way]
Buildable = 0
Accessible = 1
TextureId = 1

[Field_Gras]
Buildable = 1
Accessible = 0
TextureId = 2


[Checkpoints]
Point1_X = 38 
Point1_Y = 1
Point2_X = 38 
Point2_Y = 75

[Map]
Row1  = GGGGGGGGGGGGGGGGGGGGGGGGGGGGGGGGGGGGG+GGGGGGGGGGGGGGGGGGGGGGGGGGGGGGGGGGGGG
Row2  = GGGGGGGGGGGGGGGGGGGGGGGGGGGGGGGGGGGGG+GGGGGGGGGGGGGGGGGGGGGGGGGGGGGGGGGGGGG
Row3  = GGGGGGGGGGGGGGGGGGGGGGGGGGGGGGGGGGGGG+GGGGGGGGGGGGGGGGGGGGGGGGGGGGGGGGGGGGG
Row4  = GGGGGGGGGGGGGGGGGGGGGGGGGGGGGGGGGGGGG+GGGGGGGGGGGGGGGGGGGGGGGGGGGGGGGGGGGGG
Row5  = GGGGGGGGGGGGGGGGGGGGGGGGGGGGGGGGGGGGG+GGGGGGGGGGGGGGGGGGGGGGGGGGGGGGGGGGGGG
Row6  = GGGGGGGGGGGGGGGGGGGGGGGGGGGGGGGGGGGGG+GGGGGGGGGGGGGGGGGGGGGGGGGGGGGGGGGGGGG
Row7  = GGGGGGGGGGGGGGGGGGGGGGGGGGGGGGGGGGGGG+GGGGGGGGGGGGGGGGGGGGGGGGGGGGGGGGGGGGG
Row8  = GGGGGGGGGGGGGGGGGGGGGGGGGGGGGGGGGGGGG+GGGGGGGGGGGGGGGGGGGGGGGGGGGGGGGGGGGGG
Row9  = GGGGGGGGGGGGGGGGGGGGGGGGGGGGGGGGGGGGG+GGGGGGGGGGGGGGGGGGGGGGGGGGGGGGGGGGGGG
Row10 = GGGGGGGGGGGGGGGGGGGGGGGGGGGGGGGGGGGGG+++++++++++++++++++++GGGGGGGGGGGGGGGGG
Row11 = GGGGGGGGGGGGGGGGGGGGGGGGGGGGGGGGGGGGGGGGGGGGGGGGGGGGGGGGG+GGGGGGGGGGGGGGGGG
Row12 = GGGGGGGG++++++++++++++++++++++++++++++++++++++++++++++++G+GGGGGGGGGGGGGGGGG
Row13 = GGGGGGGG+GGGGGGGGGGGGGGGGGGGGGGGGGGGGGGGGGGGGGGGGGGGGGG+G+GGGGGGGGGGGGGGGGG
Row14 = GGGGGGGG+GGGGGGGGGGGGGGGGGGGGGGGGGGGGGGGGGGGGGGGGGGGGGG+G+GGGGGGGGGGGGGGGGG
Row15 = GGGGGGGG+GGGGGGGGGGGGGGGGGGGGGG+++++++++++++++++++++++++G+GGGGGGGGGGGGGGGGG
Row16 = GGGGGGGG+GGGGGGGGGGGGGGGGGGGGGG+GGGGGGGGGGGGGGGGGGGGGGGGG+GGGGGGGGGGGGGGGGG
Row17 = GGGGGGGG+GGGGGGGGGGGGGGGGGGGGGG+GGGGG+++++++++++++++++++++GGGGGGGGGGGGGGGGG
Row18 = GGGGGGGG+GGGGGGGGGGGGGGGGGGGGGG+GGGGG+GGGGGGGGGGGGGGGGGGGGGGGGGGGGGGGGGGGGG
Row19 = GGGGGGGG+GGGGGGGGGGGGGGGGGGGGGG+GGGGG+GGGGGGGGGGGGGGGGGGGGGGGGGGGGGGGGGGGGG
Row20 = GGGGGGGG+GGGGGGGGGGGGGGGGGGGGGG+GGGGG+GGGGGGGGGGGGGGGGGGGGGGGGGGGGGGGGGGGGG
Row21 = GGGGGGGG+GGGGGGGGGGGGGGGGGGGGGG+GGGGG+GGGGGGGGGGGGGGGGGGGGGGGGGGGGGGGGGGGGG
Row22 = GGGGGGGG+GGGGGGGGGGGGGGGGGGGGGG+GGGGG+GGGGGGGGGGGGGGGGGGGGGGGGGGGGGGGGGGGGG
Row23 = GGGGGGGG+GGGGGGGGGGGGGGGGGGGGGG+GGGGG+GGGGGGGGGGGGGGGGGGGGGGGGGGGGGGGGGGGGG
Row24 = GGGGGGGG+GGGGGGGGGGGGGGGGGGGGGG+++++++GGGGGGGGGGGGGGGGGGGGGGGGGGGGGGGGGGGGG
Row25 = GGGGGGGG+GGGGGGGGGGGGGGGGGGGGGGGGGGGGGGGGGGGGGGGGGGGGGGGGGGGGGGGGGGGGGGGGGG
Row26 = GGGGGGGG+GGGGGGGGGGGGGGGGGGGGGGGGGGGGGGGGGGGGGGGGGGGGGGGGGGGGGGGGGGGGGGGGGG
Row27 = GGGGGGGG+GGGGGGGGGGGGGGGGGGGGGGGGGGGGGGGGGGGGGGGGGGGGGGGGGGGGGGGGGGGGGGGGGG
Row28 = GGGGGGGG+GGGGGGGGGGGGGGGGGGGGGGGGGGGGGGGGGGGGGGGGGGGGGGGGGGGGGGGGGGGGGGGGGG
Row29 = GGGGGGGG++++++++++++++++++++++++++++++GGGGGGGGGGGGGGGGGGGGGGGGGGGGGGGGGGGGG
Row30 = GGGGGGGGGGGGGGGGGGGGGGGGGGGGGGGGGGGGG+GGGGGGGGGGGGGGGGGGGGGGGGGGGGGGGGGGGGG
Row31 = GGGGGGGGGGGGGGGGGGGGGGGGGGGGGGGGGGGGG+GGGGGGGGGGGGGGGGGGGGGGGGGGGGGGGGGGGGG
Row32 = GGGGGGGGGGGGGGGGGGGGGGGGGGGGGGGGGGGGG+GGGGGGGGGGGGGGGGGGGGGGGGGGGGGGGGGGGGG
Row33 = GGGGGGGGGGGGGGGGGGGGGGGGGGGGGGGGGGGGG+GGGGGGGGGGGGGGGGGGGGGGGGGGGGGGGGGGGGG
Row34 = GGGGGGGGGGGGGGGGGGGGGGGGGGGGGGGGGGGGG+GGGGGGGGGGGGGGGGGGGGGGGGGGGGGGGGGGGGG
Row35 = GGGGGGGGGGGGGGGGGGGGGGGGGGGGGGGGGGGGG+GGGGGGGGGGGGGGGGGGGGGGGGGGGGGGGGGGGGG
Row36 = GGGGGGGGGGGGGGGGGGGGGGGGGGGGGGGGGGGGG+GGGGGGGGGGGGGGGGGGGGGGGGGGGGGGGGGGGGG
Row37 = GGGGGGGGGGGGGGGGGGGGGGGGGGGGGGGGGGGGG+GGGGGGGGGGGGGGGGGGGGGGGGGGGGGGGGGGGGG
Row38 = GGGGGGGGGGGGGGGGGGGGGGGGGGGGGGGGGGGGG+GGGGGGGGGGGGGGGGGGGGGGGGGGGGGGGGGGGGG
Row39 = GGGGGGGGGGGGGGGGGGGGGGGGGGGGGGGGGGGGG+++++++++++++++++++++GGGGGGGGGGGGGGGGG
Row40 = GGGGGGGGGGGGGGGGGGGGGGGGGGGGGGGGGGGGGGGGGGGGGGGGGGGGGGGGG+GGGGGGGGGGGGGGGGG
Row41 = GGGGGGGG++++++++++++++++++++++++++++++++++++++++++++++++G+GGGGGGGGGGGGGGGGG
Row42 = GGGGGGGG+GGGGGGGGGGGGGGGGGGGGGGGGGGGGGGGGGGGGGGGGGGGGGG+G+GGGGGGGGGGGGGGGGG
Row43 = GGGGGGGG+GGGGGGGGGGGGGGGGGGGGGGGGGGGGGGGGGGGGGGGGGGGGGG+G+GGGGGGGGGGGGGGGGG
Row44 = GGGGGGGG+GGGGGGGGGGGGGGGGGGGGGG+++++++++++++++++++++++++G+GGGGGGGGGGGGGGGGG
Row45 = GGGGGGGG+GGGGGGGGGGGGGGGGGGGGGG+GGGGGGGGGGGGGGGGGGGGGGGGG+GGGGGGGGGGGGGGGGG
Row46 = GGGGGGGG+GGGGGGGGGGGGGGGGGGGGGG+GGGGG+++++++++++++++++++++GGGGGGGGGGGGGGGGG
Row47 = GGGGGGGG+GGGGGGGGGGGGGGGGGGGGGG+GGGGG+GGGGGGGGGGGGGGGGGGGGGGGGGGGGGGGGGGGGG
Row48 = GGGGGGGG+GGGGGGGGGGGGGGGGGGGGGG+GGGGG+GGGGGGGGGGGGGGGGGGGGGGGGGGGGGGGGGGGGG
Row49 = GGGGGGGG+GGGGGGGGGGGGGGGGGGGGGG+GGGGG+GGGGGGGGGGGGGGGGGGGGGGGGGGGGGGGGGGGGG
Row50 = GGGGGGGG+GGGGGGGGGGGGGGGGGGGGGG+GGGGG+GGGGGGGGGGGGGGGGGGGGGGGGGGGGGGGGGGGGG
Row51 = GGGGGGGG+GGGGGGGGGGGGGGGGGGGGGG+GGGGG+GGGGGGGGGGGGGGGGGGGGGGGGGGGGGGGGGGGGG
Row52 = GGGGGGGG+GGGGGGGGGGGGGGGGGGGGGG+GGGGG+GGGGGGGGGGGGGGGGGGGGGGGGGGGGGGGGGGGGG
Row53 = GGGGGGGG+GGGGGGGGGGGGGGGGGGGGGG+++++++GGGGGGGGGGGGGGGGGGGGGGGGGGGGGGGGGGGGG
Row54 = GGGGGGGG+GGGGGGGGGGGGGGGGGGGGGGGGGGGGGGGGGGGGGGGGGGGGGGGGGGGGGGGGGGGGGGGGGG
Row55 = GGGGGGGG+GGGGGGGGGGGGGGGGGGGGGGGGGGGGGGGGGGGGGGGGGGGGGGGGGGGGGGGGGGGGGGGGGG
Row56 = GGGGGGGG+GGGGGGGGGGGGGGGGGGGGGGGGGGGGGGGGGGGGGGGGGGGGGGGGGGGGGGGGGGGGGGGGGG
Row57 = GGGGGGGG+GGGGGGGGGGGGGGGGGGGGGGGGGGGGGGGGGGGGGGGGGGGGGGGGGGGGGGGGGGGGGGGGGG
Row58 = GGGGGGGG++++++++++++++++++++++++++++++GGGGGGGGGGGGGGGGGGGGGGGGGGGGGGGGGGGGG
Row59 = GGGGGGGGGGGGGGGGGGGGGGGGGGGGGGGGGGGGG+GGGGGGGGGGGGGGGGGGGGGGGGGGGGGGGGGGGGG
Row60 = GGGGGGGGGGGGGGGGGGGGGGGGGGGGGGGGGGGGG+GGGGGGGGGGGGGGGGGGGGGGGGGGGGGGGGGGGGG
Row61 = GGGGGGGGGGGGGGGGGGGGGGGGGGGGGGGGGGGGG+GGGGGGGGGGGGGGGGGGGGGGGGGGGGGGGGGGGGG
Row62 = GGGGGGGGGGGGGGGGGGGGGGGGGGGGGGGGGGGGG+GGGGGGGGGGGGGGGGGGGGGGGGGGGGGGGGGGGGG
Row63 = GGGGGGGGGGGGGGGGGGGGGGGGGGGGGGGGGGGGG+GGGGGGGGGGGGGGGGGGGGGGGGGGGGGGGGGGGGG
Row64 = GGGGGGGGGGGGGGGGGGGGGGGGGGGGGGGGGGGGG+GGGGGGGGGGGGGGGGGGGGGGGGGGGGGGGGGGGGG
Row65 = GGGGGGGGGGGGGGGGGGGGGGGGGGGGGGGGGGGGG+GGGGGGGGGGGGGGGGGGGGGGGGGGGGGGGGGGGGG
Row66 = GGGGGGGGGGGGGGGGGGGGGGGGGGGGGGGGGGGGG+GGGGGGGGGGGGGGGGGGGGGGGGGGGGGGGGGGGGG
Row67 = GGGGGGGGGGGGGGGGGGGGGGGGGGGGGGGGGGGGG+GGGGGGGGGGGGGGGGGGGGGGGGGGGGGGGGGGGGG
Row68 = GGGGGGGGGGGGGGGGGGGGGGGGGGGGGGGGGGGGG+GGGGGGGGGGGGGGGGGGGGGGGGGGGGGGGGGGGGG
Row69 = GGGGGGGGGGGGGGGGGGGGGGGGGGGGGGGGGGGGG+GGGGGGGGGGGGGGGGGGGGGGGGGGGGGGGGGGGGG
Row70 = GGGGGGGGGGGGGGGGGGGGGGGGGGGGGGGGGGGGG+GGGGGGGGGGGGGGGGGGGGGGGGGGGGGGGGGGGGG
Row71 = GGGGGGGGGGGGGGGGGGGGGGGGGGGGGGGGGGGGG+GGGGGGGGGGGGGGGGGGGGGGGGGGGGGGGGGGGGG
Row72 = GGGGGGGGGGGGGGGGGGGGGGGGGGGGGGGGGGGGG+GGGGGGGGGGGGGGGGGGGGGGGGGGGGGGGGGGGGG
Row73 = GGGGGGGGGGGGGGGGGGGGGGGGGGGGGGGGGGGGG+GGGGGGGGGGGGGGGGGGGGGGGGGGGGGGGGGGGGG
Row74 = GGGGGGGGGGGGGGGGGGGGGGGGGGGGGGGGGGGGG+GGGGGGGGGGGGGGGGGGGGGGGGGGGGGGGGGGGGG
Row75 = GGGGGGGGGGGGGGGGGGGGGGGGGGGGGGGGGGGGG+GGGGGGGGGGGGGGGGGGGGGGGGGGGGGGGGGGGGG